\\..../........-...-........-.-.|..................-...........................-.........-...---..............
..../.....................\...........|........|...........\...|./...-...|..|.|-.....-.....|........\....../..
............|...........\.....................\....|.....|/./........../.....................-................
.......\.|.\-....--../..........\.../.../.../......................\.............\............................
.............\/...../..........................|....-.....-.......\|...........-....|.........................
.-............-../......|.............-................../|....-...-....../|...-....--...\.......\..|.......-.
.......-......./....................\......................\.....|........../.......\............|..\../.../..
........................-.....\.......\........................./............................|......\..-......
...................-................./......|.....-....\\............./.....\.................................
.............|.........................\.|.....|\....../.......|..............\\../..................../......
-......\......./........\.-/...................|../-./................/.........................|......\.....|
..........................\...........................\...........................|...........................
....-...../|.............................-........./...-..................|..........\..\................\....
............/........-.-.................//..\................................-.......|.-............//....-..
.......-.....|.\........\...|....-......./......\.......-.......\...................../...\...................
...\.|..-........./........................-.....|..-............................\..-.........................
..../.........................................--.............|...................................\..../....../
..........\...........--........./.|.......\./................/.........\.|..|......\........-//............./
...\.|..\......\.......-\........\|......./.......\..|...........-..............\-..|...................\.....
..../........|..|.........................../..\....................|.......\.......................-........\
.....\.......\...\.|.........\.................|......|..-...................-.../.\...................|......
........\................./..............-....-..................|.....\|\................./...../............
.|................\../..........................|.....\.......................................................
...|.........................|........|...|...\.-.-...................\..|./..\\......|.../..................-
......-..................................|.................................\.|.\..-........\..................
.-..........\|..-.....-.\..-...............\........-.....................-.....|....................\..|.....
..../....-..............................-\................................................................../.
............./....................\...................|...........\.../.............-......-....-.............
........../....../..-.|.............\\......../.....................|....-..........\.........\....../........
.............|......\......../../..........|...........-......\|........\...........././....\..........|......
......-................../.....-................-..............\.-..............|................|............
...-...-./..................................................|.\..\........\-........-.................\.......
.......................\.\.........|................\....../.|....\.../..\.|\.....-.|..............-..........
..-.........-|...\.\....|.-.\........................\........................./.-................/..........-
.........|.......-.................\/......../...............\..|..................|....|..\..|.............\.
......\........................-......\..-...-..........-......./....\........................\..............-
.......\...-....\\...........................\......................./..|../........./................|....../
...............|...|..\..-......................../............\-............/.\..........-........|.........\
...-..\......|......\............/................/...\../.|../...........|-...........\.........\.....-..|...
.........\.....-......|..................-.....................................................-.............|
....../.....|.................|./....-\......................|...-..............|...\..-.......|.......-../...
................................/............\..........\................./............\.-.....|............/.
........\.............\.......|..................-.......................-....................................
....-.-................\..............-......-.../............\............................../|...............
............................\.\..........././........|..\/....-|...................\.......-...../.\..........
-.................../...\....../.|.........................../..........\...........\..........|......-.......
...|-|...............|...\..../|.............-...............\.........-....|-...................|............
..\\.......\.....|....\./\............./.|...../...\...........................-.......--......-.......\\.....
....-..//...../....................|....-...../\..................................|......................-....
......................................../..-...................../.......|.--......\....|..-..\...............
.......-..\........../..................-........\...........|..|.....\...-.....\../.-..\.....-.||...|..-.....
/./....../|...................-............/.....|..-..................................|........./\....-......
................/............................/......-...\...............................\..........-....-....|
.........\.....\......-.....\.........................-............./........./......\...................\....
.....................|...................|...........-............./........\.........../.................\...
........................................../................-|.......||....\...|......\........................
|..-.../|......-............-.....||...|...........-./....................../...\....\-........//......\......
../.-......../........./.-..|..|....||........./......-..\................../.....|.....|...|....|\...........
.-/..\...........\........\...............\..................|......../............-...........-..........|...
...|..|................|............./\....-....-...-......-......-................-................/........|
..-....\....|...../..........|..-./.\......./|.........\.....-|.......\.......................-...|...........
-.......\\...................-....\|........|............|.......................\.............\....../....\./
-......................................../.............-./\.........\.|......./|......../.....|...............
........-.\\\...............-.../............\.................||.............../../..........................
.....................\............\............................-..|.........\......................../........
\..././.....|....|.....-............\./....-.............|..-...-..........-.|....-...\..........|....\.......
.|..........|.....|.......\................................../......./.../...|....\...-..-...\................
..\...\......-..........................................-.........../........--..........--......|............
................................||...-.....|.....-.\..............\.|...\...............-...-.................
............................../..\..|....../.......\......\...-..|../............-.......................\..\.
./............./..|.......|............-.........|.......\../...................|....\...................../..
.|...................|\...................|.....................-.......\...|................-|...............
/|......./../.........\.................\............../.../......|....|......./....|-..........\.............
............|....\.............-.....-./|/.................../......./.\...-.........-..................|.....
.-.../..........................\\.......|.......|.....-........../........\.................|.|..............
....-.\....................../.-......||................/\\.........../..............|........................
\/.....\....-......|...................|.\......\.|............/...\.|.../................|.\.................
..-.\...............-......../.......\....../........-.......-\....../......|../..................|../........
..-./..........\.....................................|.........-.......|................/........|............
.............-....../......./......................|.............../............\..../........................
..|......-........|...................-...........|............../........................|../................
..../..........|-.....-......./....../......./.\.....\.........-...|......................................\...
....\......../..................../..-......|..............-.................||...........\.\...|/............
........\.............|.................................\......./.............-.......|..............\.-......
.....|...........-.............|..........-......\..................................|..-............\.../.\.-.
..................................\...........\...\.......\................\-.................../.............
......-............../...........-......\./..........|..\..................|...|....|...|-./..............|...
........\..|.\......................../..........\..........\.|..|../....\..|.....|.|..............\..-.......
...........-..........|..../.-........../..................|......./.................\.............../........
..........-..../\....\........./............/..................\..........-/................................//
.............-../.-.............\.............../-....-....|..../.............|...............................
........./............|....................|./........\...../................................-.......|........
........./..../..........\..\.....././.........|...........\..................../....../...\.........../.../..
.-....\.........\....-............/...................-.....|.....................|...........................
................-.......................|.........|.................................................\.......|.
...../............|....//...../................|.\...........|............\.....|-........|.........\.........
\..././-....................|...................-..............-..............|.........|....|............./..
..-...........................././-./...\-.................|...-.....-/........\....|............\-..-........
...............|...............//........../.......-.-......................-.........|.............\.........
../............/..................\\......../............................\................../........./.......
......|.\...............................................|................................/.........-.-........
....\.\...\..................-..-.................\\.....-....|................\.................|............
........................./.............-...|./.................\....|....\..|...|..........\-.................
..........|.............\..................\..................../.\.......|..................\/......|........
............|....\..\..../...........-....\....................\...........................-../...............
.....................|......../.././.............\......|.-......\.............-../...|...............-......|
..................-...................................................-.............\............./.|......-..
...\.............||...........................\........\......-......-..\...\...\............./-...........|..
...\........|...................|.......|.............|..-......../..-...-............/.........\....|........
......-...........|................./......|.....-./|..\\...............\|././...............-........\....\..